1111111111111111111111111111111111
1E000P000000000C00000C000000000001
10100101001000001P1001000000010101
1010010010101010001001000P00010101
1P0000000C00C0000000000000000000C1
1111111111111111111111111111111111
