1111111
1001001
1000001
1000011
1P000E1
1111111