1111111111
1P001010C1
10000C0001
1C010001E1
1111111111