1111111
10010C1
1C00001
1A00011
1P000E1
1111111